1,"Baldwin, Tammy",Retired,6190355,6190355,0
2,"Baldwin, Tammy",Women's Issues,1756613,1716021,40592
3,"Baldwin, Tammy",Lawyers/Law Firms,1560354,1486954,73400
4,"Baldwin, Tammy",Education,1506754,1506754,0
5,"Baldwin, Tammy",Health Professionals,1126477,924177,202300
6,"Barrasso, John",Securities & Investment,663396,550396,113000
7,"Barrasso, John",Oil & Gas,615287,259387,355900
8,"Barrasso, John",Health Professionals,530214,259714,270500
9,"Barrasso, John",Retired,401781,401781,0
10,"Barrasso, John",Lobbyists,362273,360273,2000
11,"Bennet, Michael F.",Retired,2233789,2233789,0
12,"Bennet, Michael F.",Securities & Investment,1614568,1591568,23000
13,"Bennet, Michael F.",Lawyers/Law Firms,1108413,1053163,55250
14,"Bennet, Michael F.",Democratic/Liberal,769757,735857,33900
15,"Bennet, Michael F.",Real Estate,534024,501524,32500
16,"Blackburn, Marsha",Retired,2684112,2684112,0
17,"Blackburn, Marsha",Republican/Conservative,1836274,1761869,74405
18,"Blackburn, Marsha",Securities & Investment,864944,842944,22000
19,"Blackburn, Marsha",Real Estate,855633,812633,43000
20,"Blackburn, Marsha",Health Professionals,698834,458959,239875
21,"Blumenthal, Richard",Lawyers/Law Firms,1227996,1157496,70500
22,"Blumenthal, Richard",Retired,806246,806246,0
23,"Blumenthal, Richard",Securities & Investment,716580,698580,18000
24,"Blumenthal, Richard",Leadership PACs,374900,0,374900
25,"Blumenthal, Richard",Real Estate,322804,277804,45000
26,"Blunt, Roy",Retired,203757,203757,0
27,"Blunt, Roy",Lobbyists,153000,145000,8000
28,"Blunt, Roy",Lawyers/Law Firms,139086,78886,60200
29,"Blunt, Roy",Pharmaceuticals/Health Products,116588,15588,101000
30,"Blunt, Roy",Securities & Investment,109994,73394,36600
31,"Booker, Cory A.",Securities & Investment,1300575,1303275,-2700
32,"Booker, Cory A.",Lawyers/Law Firms,1277062,1257462,19600
33,"Booker, Cory A.",Retired,1220499,1220499,0
34,"Booker, Cory A.",Real Estate,681776,681776,0
35,"Booker, Cory A.",TV/Movies/Music,594843,595343,-500
36,"Boozman, John",Leadership PACs,524550,0,524550
37,"Boozman, John",Crop Production & Basic Processing,494630,214380,280250
38,"Boozman, John",Securities & Investment,449355,339605,109750
39,"Boozman, John",Health Professionals,323426,139426,184000
40,"Boozman, John",Lobbyists,248438,241315,7123
41,"Braun, Mike",Retired,1023715,1023715,0
42,"Braun, Mike",Securities & Investment,603800,588100,15700
43,"Braun, Mike",Republican/Conservative,540911,502912,37999
44,"Braun, Mike",Real Estate,369796,357796,12000
45,"Braun, Mike",Health Professionals,270491,244491,26000
46,"Brown, Sherrod",Retired,3621045,3621045,0
47,"Brown, Sherrod",Lawyers/Law Firms,2058944,1919494,139450
48,"Brown, Sherrod",Education,1300118,1300118,0
49,"Brown, Sherrod",Health Professionals,1083486,852386,231100
50,"Brown, Sherrod",Securities & Investment,949427,798927,150500
51,"Burr, Richard",Leadership PACs,184700,0,184700
52,"Burr, Richard",Lobbyists,47000,47000,0
53,"Burr, Richard",Pharmaceuticals/Health Products,39900,13400,26500
54,"Burr, Richard",Health Professionals,33250,30250,3000
55,"Burr, Richard",Health Services/HMOs,27200,11200,16000
56,"Cantwell, Maria",Retired,1382390,1382390,0
57,"Cantwell, Maria",Lawyers/Law Firms,694678,694928,-250
58,"Cantwell, Maria",Real Estate,551409,551062,347
59,"Cantwell, Maria",Securities & Investment,456622,456622,0
60,"Cantwell, Maria",Women's Issues,442879,443123,-244
61,"Capito, Shelley Moore",Retired,542273,542273,0
62,"Capito, Shelley Moore",Leadership PACs,417500,0,417500
63,"Capito, Shelley Moore",Securities & Investment,411665,364026,47639
64,"Capito, Shelley Moore",Oil & Gas,331794,114794,217000
65,"Capito, Shelley Moore",Lawyers/Law Firms,250128,160878,89250
66,"Cardin, Benjamin L.",Securities & Investment,328771,239271,89500
67,"Cardin, Benjamin L.",Real Estate,311822,258322,53500
68,"Cardin, Benjamin L.",Lawyers/Law Firms,308363,238895,69468
69,"Cardin, Benjamin L.",Health Professionals,273210,116710,156500
70,"Cardin, Benjamin L.",Insurance,240085,72585,167500
71,"Carper, Thomas R.",Securities & Investment,349030,201530,147500
72,"Carper, Thomas R.",Insurance,347198,134198,213000
73,"Carper, Thomas R.",Pharmaceuticals/Health Products,327985,58885,269100
74,"Carper, Thomas R.",Lawyers/Law Firms,248974,163554,85420
75,"Carper, Thomas R.",Leadership PACs,228500,0,228500
76,"Casey, Robert P., Jr.",Lawyers/Law Firms,4606364,4422570,183794
77,"Casey, Robert P., Jr.",Retired,2518606,2518606,0
78,"Casey, Robert P., Jr.",Securities & Investment,1605689,1484889,120800
79,"Casey, Robert P., Jr.",Education,1230423,1230423,0
80,"Casey, Robert P., Jr.",Real Estate,1160443,1106443,54000
81,"Cassidy, Bill",Health Professionals,1177001,827312,349689
82,"Cassidy, Bill",Securities & Investment,1124881,1049581,75300
83,"Cassidy, Bill",Retired,901054,901054,0
84,"Cassidy, Bill",Oil & Gas,530273,285673,244600
85,"Cassidy, Bill",Lawyers/Law Firms,511708,379458,132250
86,"Collins, Susan M.",Retired,6536151,6536151,0
87,"Collins, Susan M.",Securities & Investment,2094435,2004935,89500
88,"Collins, Susan M.",Real Estate,1184425,1119175,65250
89,"Collins, Susan M.",Lawyers/Law Firms,802477,683877,118600
90,"Collins, Susan M.",Health Professionals,677244,425694,251550
91,"Coons, Christopher A.",Lawyers/Law Firms,895217,752717,142500
92,"Coons, Christopher A.",Securities & Investment,771845,669845,102000
93,"Coons, Christopher A.",Real Estate,377842,318842,59000
94,"Coons, Christopher A.",Pharmaceuticals/Health Products,352555,99105,253450
95,"Coons, Christopher A.",Leadership PACs,306600,5000,301600
96,"Cornyn, John",Retired,6224963,6224963,0
97,"Cornyn, John",Republican/Conservative,2407741,2386141,21600
98,"Cornyn, John",Securities & Investment,2407423,2259173,148250
99,"Cornyn, John",Real Estate,1580644,1496144,84500
100,"Cornyn, John",Oil & Gas,1478505,1199405,279100
101,"Cortez Masto, Catherine",Retired,6175079,6175079,0
102,"Cortez Masto, Catherine",Democratic/Liberal,3107102,3037332,69770
103,"Cortez Masto, Catherine",Lawyers/Law Firms,2110492,2018951,91541
104,"Cortez Masto, Catherine",Women's Issues,1717947,1665642,52305
105,"Cortez Masto, Catherine",Securities & Investment,1517500,1420500,97000
106,"Cotton, Tom",Retired,3169954,3169954,0
107,"Cotton, Tom",Securities & Investment,1813405,1710705,102700
108,"Cotton, Tom",Republican/Conservative,1189728,1161378,28350
109,"Cotton, Tom",Real Estate,749033,708033,41000
110,"Cotton, Tom",Lawyers/Law Firms,465521,416021,49500
111,"Cramer, Kevin",Securities & Investment,591772,556272,35500
112,"Cramer, Kevin",Oil & Gas,513775,415575,98200
113,"Cramer, Kevin",Retired,484919,484919,0
114,"Cramer, Kevin",Leadership PACs,276000,0,276000
115,"Cramer, Kevin",Real Estate,238719,230719,8000
116,"Crapo, Mike",Securities & Investment,788868,548368,240500
117,"Crapo, Mike",Leadership PACs,484200,0,484200
118,"Crapo, Mike",Insurance,474950,145950,329000
119,"Crapo, Mike",Real Estate,391348,272848,118500
120,"Crapo, Mike",Pharmaceuticals/Health Products,379175,136625,242550
121,"Cruz, Ted",Retired,10370446,10370446,0
122,"Cruz, Ted",Republican/Conservative,5702587,5654387,48200
123,"Cruz, Ted",Real Estate,1506584,1496584,10000
124,"Cruz, Ted",Securities & Investment,1328286,1314786,13500
125,"Cruz, Ted",Health Professionals,1229283,1188133,41150
126,"Daines, Steve",Retired,7998005,7998005,0
127,"Daines, Steve",Republican/Conservative,3560054,3462454,97600
128,"Daines, Steve",Securities & Investment,1404155,1245155,159000
129,"Daines, Steve",Real Estate,1337825,1245825,92000
130,"Daines, Steve",Health Professionals,756507,610507,146000
131,"Duckworth, Tammy",Retired,2690757,2690757,0
132,"Duckworth, Tammy",Women's Issues,794595,756889,37706
133,"Duckworth, Tammy",Democratic/Liberal,774582,761582,13000
134,"Duckworth, Tammy",Lawyers/Law Firms,574101,529301,44800
135,"Duckworth, Tammy",Education,380624,379624,1000
136,"Durbin, Richard J.",Lawyers/Law Firms,1470753,1383753,87000
137,"Durbin, Richard J.",Retired,971002,971002,0
138,"Durbin, Richard J.",Securities & Investment,408103,367103,41000
139,"Durbin, Richard J.",Health Professionals,395804,259304,136500
140,"Durbin, Richard J.",Real Estate,349101,306101,43000
141,"Ernst, Joni",Retired,7726617,7726617,0
142,"Ernst, Joni",Republican/Conservative,2543832,2461132,82700
143,"Ernst, Joni",Securities & Investment,1578936,1519374,59562
144,"Ernst, Joni",Real Estate,1160552,1110052,50500
145,"Ernst, Joni",Health Professionals,650837,595337,55500
146,"Feinstein, Dianne",Lawyers/Law Firms,588109,534659,53450
147,"Feinstein, Dianne",Retired,571817,571817,0
148,"Feinstein, Dianne",Securities & Investment,458153,443653,14500
149,"Feinstein, Dianne",Real Estate,453953,425553,28400
150,"Feinstein, Dianne",TV/Movies/Music,311747,274497,37250
151,"Fischer, Deb",Leadership PACs,359700,0,359700
152,"Fischer, Deb",Retired,315064,315064,0
153,"Fischer, Deb",Lobbyists,262489,256841,5648
154,"Fischer, Deb",Securities & Investment,239848,216848,23000
155,"Fischer, Deb",Lawyers/Law Firms,230660,120685,109975
156,"Gillibrand, Kirsten E.",Lawyers/Law Firms,2627369,2596761,30608
157,"Gillibrand, Kirsten E.",Securities & Investment,1496727,1475727,21000
158,"Gillibrand, Kirsten E.",Retired,1458811,1458811,0
159,"Gillibrand, Kirsten E.",Real Estate,715908,698908,17000
160,"Gillibrand, Kirsten E.",Education,559000,559000,0
161,"Graham, Lindsey",Retired,28416807,28416807,0
162,"Graham, Lindsey",Real Estate,2916569,2868069,48500
163,"Graham, Lindsey",Republican/Conservative,2775850,2712650,63200
164,"Graham, Lindsey",Health Professionals,2085070,2043070,42000
165,"Graham, Lindsey",Lawyers/Law Firms,2065145,1955645,109500
166,"Grassley, Chuck",Retired,1042232,1042232,0
167,"Grassley, Chuck",Securities & Investment,516033,434783,81250
168,"Grassley, Chuck",Leadership PACs,415600,0,415600
169,"Grassley, Chuck",Insurance,295571,83521,212050
170,"Grassley, Chuck",Real Estate,292366,199366,93000
171,"Hagerty, Bill",Securities & Investment,1157959,1108959,49000
172,"Hagerty, Bill",Retired,1074655,1074655,0
173,"Hagerty, Bill",Real Estate,672252,638252,34000
174,"Hagerty, Bill",Lawyers/Law Firms,437099,380849,56250
175,"Hagerty, Bill",Leadership PACs,321300,0,321300
176,"Hassan, Margaret Wood",Retired,5672538,5672538,0
177,"Hassan, Margaret Wood",Lawyers/Law Firms,1807387,1713387,94000
178,"Hassan, Margaret Wood",Securities & Investment,1677192,1517692,159500
179,"Hassan, Margaret Wood",Democratic/Liberal,1632678,1550508,82170
180,"Hassan, Margaret Wood",Women's Issues,1332077,1286872,45205
181,"Hawley, Josh",Retired,3415200,3415200,0
182,"Hawley, Josh",Republican/Conservative,2370393,2296293,74100
183,"Hawley, Josh",Securities & Investment,832764,824564,8200
184,"Hawley, Josh",Real Estate,727762,726762,1000
185,"Hawley, Josh",Lawyers/Law Firms,470510,442010,28500
186,"Heinrich, Martin",Lawyers/Law Firms,632328,502828,129500
187,"Heinrich, Martin",Retired,536073,536073,0
188,"Heinrich, Martin",Lobbyists,400549,398549,2000
189,"Heinrich, Martin",Securities & Investment,365064,329064,36000
190,"Heinrich, Martin",Leadership PACs,339843,0,339843
191,"Hickenlooper, John W.",Retired,4715865,4715865,0
192,"Hickenlooper, John W.",Democratic/Liberal,4061158,4022358,38800
193,"Hickenlooper, John W.",Education,2450710,2450710,0
194,"Hickenlooper, John W.",Lawyers/Law Firms,2348731,2301431,47300
195,"Hickenlooper, John W.",Securities & Investment,2064164,2064164,0
196,"Hirono, Mazie K.",Lawyers/Law Firms,521987,458237,63750
197,"Hirono, Mazie K.",Retired,404852,404852,0
198,"Hirono, Mazie K.",Leadership PACs,231000,0,231000
199,"Hirono, Mazie K.",Real Estate,158113,129113,29000
200,"Hirono, Mazie K.",Women's Issues,122920,97420,25500
201,"Hoeven, John",Leadership PACs,417399,0,417399
202,"Hoeven, John",Oil & Gas,288632,134799,153833
203,"Hoeven, John",Securities & Investment,235953,204953,31000
204,"Hoeven, John",Crop Production & Basic Processing,233850,79350,154500
205,"Hoeven, John",Pro-Israel,182917,169017,13900
206,"Hyde-Smith, Cindy",Retired,761297,761297,0
207,"Hyde-Smith, Cindy",Leadership PACs,649167,10567,638600
208,"Hyde-Smith, Cindy",Crop Production & Basic Processing,449758,277758,172000
209,"Hyde-Smith, Cindy",Oil & Gas,381684,235984,145700
210,"Hyde-Smith, Cindy",Securities & Investment,282109,265109,17000
211,"Inhofe, James M.",Leadership PACs,504200,0,504200
212,"Inhofe, James M.",Oil & Gas,396355,164666,231689
213,"Inhofe, James M.",Retired,347042,347042,0
214,"Inhofe, James M.",Misc Defense,226650,137150,89500
215,"Inhofe, James M.",Defense Aerospace,195558,115558,80000
216,"Johnson, Ron",Retired,7827389,7827389,0
217,"Johnson, Ron",Republican/Conservative,2084713,2030308,54405
218,"Johnson, Ron",Securities & Investment,1022107,1014607,7500
219,"Johnson, Ron",Real Estate,798186,770186,28000
220,"Johnson, Ron",Leadership PACs,469700,0,469700
221,"Kaine, Tim",Lawyers/Law Firms,2373358,2228808,144550
222,"Kaine, Tim",Retired,1776779,1776779,0
223,"Kaine, Tim",Securities & Investment,1457346,1381846,75500
224,"Kaine, Tim",Real Estate,880522,832622,47900
225,"Kaine, Tim",Health Professionals,603851,484851,119000
226,"Kelly, Mark",Retired,14176300,14176300,0
227,"Kelly, Mark",Democratic/Liberal,3480404,3383613,96791
228,"Kelly, Mark",Lawyers/Law Firms,2053956,2007056,46900
229,"Kelly, Mark",Education,1850823,1850823,0
230,"Kelly, Mark",Securities & Investment,1637086,1630086,7000
231,"Kennedy, John",Retired,6899604,6899604,0
232,"Kennedy, John",Real Estate,877304,820304,57000
233,"Kennedy, John",Lawyers/Law Firms,846718,779218,67500
234,"Kennedy, John",Securities & Investment,829671,775671,54000
235,"Kennedy, John",Oil & Gas,506875,363325,143550
236,"King, Angus S., Jr.",Retired,499163,499163,0
237,"King, Angus S., Jr.",Lawyers/Law Firms,419792,382561,37231
238,"King, Angus S., Jr.",Securities & Investment,303717,279217,24500
239,"King, Angus S., Jr.",Democratic/Liberal,225188,224588,600
240,"King, Angus S., Jr.",Real Estate,225115,186615,38500
241,"Klobuchar, Amy",Retired,1612289,1612289,0
242,"Klobuchar, Amy",Lawyers/Law Firms,1180795,1119922,60873
243,"Klobuchar, Amy",Securities & Investment,801268,767768,33500
244,"Klobuchar, Amy",Women's Issues,531083,512975,18108
245,"Klobuchar, Amy",Democratic/Liberal,455872,450872,5000
246,"Lankford, James",Oil & Gas,468598,270598,198000
247,"Lankford, James",Retired,445895,445895,0
248,"Lankford, James",Leadership PACs,435699,0,435699
249,"Lankford, James",Securities & Investment,349416,254916,94500
250,"Lankford, James",Pro-Israel,256241,243541,12700
251,"Leahy, Patrick J.",Leadership PACs,180400,0,180400
252,"Leahy, Patrick J.",Lobbyists,134376,130376,4000
253,"Leahy, Patrick J.",Defense Aerospace,120288,88788,31500
254,"Leahy, Patrick J.",Lawyers/Law Firms,87829,45579,42250
255,"Leahy, Patrick J.",TV/Movies/Music,76276,39276,37000
256,"Lee, Mike",Retired,1010426,1010426,0
257,"Lee, Mike",Securities & Investment,668234,647234,21000
258,"Lee, Mike",Republican/Conservative,476848,406015,70833
259,"Lee, Mike",Leadership PACs,417100,0,417100
260,"Lee, Mike",Lawyers/Law Firms,265926,217926,48000
261,"Luján, Ben Ray",Retired,1381311,1381311,0
262,"Luján, Ben Ray",Democratic/Liberal,541727,536784,4943
263,"Luján, Ben Ray",Lawyers/Law Firms,540768,490768,50000
264,"Luján, Ben Ray",Leadership PACs,484245,18201,466044
265,"Luján, Ben Ray",Securities & Investment,392193,381193,11000
266,"Lummis, Cynthia M.",Republican/Conservative,368042,355942,12100
267,"Lummis, Cynthia M.",Leadership PACs,329000,0,329000
268,"Lummis, Cynthia M.",Retired,188210,188210,0
269,"Lummis, Cynthia M.",Oil & Gas,146226,33726,112500
270,"Lummis, Cynthia M.",Securities & Investment,125248,113918,11330
271,"Manchin, Joe, III",Securities & Investment,2010743,1887743,123000
272,"Manchin, Joe, III",Retired,1080330,1080330,0
273,"Manchin, Joe, III",Lawyers/Law Firms,1072190,873115,199075
274,"Manchin, Joe, III",Real Estate,954095,885195,68900
275,"Manchin, Joe, III",Oil & Gas,928616,593017,335599
276,"Markey, Edward J.",Retired,1352820,1352820,0
277,"Markey, Edward J.",Lawyers/Law Firms,1091924,1032274,59650
278,"Markey, Edward J.",Securities & Investment,755251,744251,11000
279,"Markey, Edward J.",Education,699252,699252,0
280,"Markey, Edward J.",Democratic/Liberal,649222,641222,8000
281,"Marshall, Roger",Retired,587000,587000,0
282,"Marshall, Roger",Health Professionals,463452,228753,234699
283,"Marshall, Roger",Securities & Investment,351946,308646,43300
284,"Marshall, Roger",Leadership PACs,305291,0,305291
285,"Marshall, Roger",Real Estate,207079,180079,27000
286,"McConnell, Mitch",Retired,24336607,24336607,0
287,"McConnell, Mitch",Securities & Investment,2068133,1875133,193000
288,"McConnell, Mitch",Real Estate,1992638,1895139,97499
289,"McConnell, Mitch",Health Professionals,1595612,1406812,188800
290,"McConnell, Mitch",Republican/Conservative,1191907,1126057,65850
291,"Menendez, Robert",Lawyers/Law Firms,1698607,1551357,147250
292,"Menendez, Robert",Real Estate,1410318,1297818,112500
293,"Menendez, Robert",Securities & Investment,1087373,983373,104000
294,"Menendez, Robert",Health Professionals,823076,804076,19000
295,"Menendez, Robert",Pro-Israel,726022,618022,108000
296,"Merkley, Jeff",Retired,2428112,2428112,0
297,"Merkley, Jeff",Democratic/Liberal,586947,574947,12000
298,"Merkley, Jeff",Education,457693,457693,0
299,"Merkley, Jeff",Health Professionals,295093,255093,40000
300,"Merkley, Jeff",Leadership PACs,290100,0,290100
301,"Moran, Jerry",Securities & Investment,472225,309525,162700
302,"Moran, Jerry",Leadership PACs,416043,4900,411143
303,"Moran, Jerry",Real Estate,293136,213636,79500
304,"Moran, Jerry",Retired,275613,275613,0
305,"Moran, Jerry",Lobbyists,263628,262628,1000
306,"Murkowski, Lisa",Securities & Investment,921619,866619,55000
307,"Murkowski, Lisa",Retired,859689,859689,0
308,"Murkowski, Lisa",Oil & Gas,490799,305616,185183
309,"Murkowski, Lisa",Leadership PACs,430433,0,430433
310,"Murkowski, Lisa",Electric Utilities,378925,85175,293750
311,"Murphy, Christopher",Retired,1776782,1776782,0
312,"Murphy, Christopher",Lawyers/Law Firms,1196643,1161393,35250
313,"Murphy, Christopher",Securities & Investment,810676,762176,48500
314,"Murphy, Christopher",Education,544806,544806,0
315,"Murphy, Christopher",Health Professionals,542230,381730,160500
316,"Murray, Patty",Retired,2199356,2199356,0
317,"Murray, Patty",Lawyers/Law Firms,681033,571433,109600
318,"Murray, Patty",Pharmaceuticals/Health Products,522264,134481,387783
319,"Murray, Patty",Health Professionals,501017,252517,248500
320,"Murray, Patty",Women's Issues,478187,440287,37900
321,"Ossoff, Jon",Democratic/Liberal,21040949,20945112,95837
322,"Ossoff, Jon",Retired,10866838,10866838,0
323,"Ossoff, Jon",Education,9166056,9166056,0
324,"Ossoff, Jon",Lawyers/Law Firms,6795321,6771521,23800
325,"Ossoff, Jon",Health Professionals,5129750,5124750,5000
326,"Padilla, Alex",Lawyers/Law Firms,1236534,1174534,62000
327,"Padilla, Alex",Securities & Investment,626326,606826,19500
328,"Padilla, Alex",Retired,503695,503695,0
329,"Padilla, Alex",Leadership PACs,475800,0,475800
330,"Padilla, Alex",Real Estate,459591,431091,28500
331,"Paul, Rand",Retired,3608259,3608259,0
332,"Paul, Rand",Republican/Conservative,2153957,2115816,38141
333,"Paul, Rand",Securities & Investment,563616,548616,15000
334,"Paul, Rand",Health Professionals,492893,430893,62000
335,"Paul, Rand",Real Estate,453611,441611,12000
336,"Peters, Gary C.",Retired,6393822,6393822,0
337,"Peters, Gary C.",Education,3232011,3230261,1750
338,"Peters, Gary C.",Lawyers/Law Firms,3161315,2993453,167862
339,"Peters, Gary C.",Democratic/Liberal,2785480,2729256,56224
340,"Peters, Gary C.",Securities & Investment,2422542,2230696,191846
341,"Portman, Rob",Securities & Investment,513296,395796,117500
342,"Portman, Rob",Insurance,366205,186205,180000
343,"Portman, Rob",Retired,327893,327893,0
344,"Portman, Rob",Lawyers/Law Firms,249231,158481,90750
345,"Portman, Rob",Real Estate,238786,226786,12000
346,"Reed, Jack",Leadership PACs,346100,0,346100
347,"Reed, Jack",Lawyers/Law Firms,272848,199098,73750
348,"Reed, Jack",Misc Defense,238345,123345,115000
349,"Reed, Jack",Securities & Investment,213998,140998,73000
350,"Reed, Jack",Real Estate,184226,122976,61250
351,"Risch, James E.",Leadership PACs,345217,567,344650
352,"Risch, James E.",Securities & Investment,196496,175496,21000
353,"Risch, James E.",Retired,177999,177999,0
354,"Risch, James E.",Electric Utilities,136895,6145,130750
355,"Risch, James E.",Oil & Gas,135032,53032,82000
356,"Romney, Mitt",Securities & Investment,1129219,1104219,25000
357,"Romney, Mitt",Retired,690917,690917,0
358,"Romney, Mitt",Real Estate,361491,361491,0
359,"Romney, Mitt",Lawyers/Law Firms,145321,142821,2500
360,"Romney, Mitt",Misc Manufacturing & Distributing,135690,120190,15500
361,"Rosen, Jacky",Retired,3792530,3792530,0
362,"Rosen, Jacky",Lawyers/Law Firms,2172502,2099724,72778
363,"Rosen, Jacky",Securities & Investment,1720138,1672138,48000
364,"Rosen, Jacky",Education,1539281,1539281,0
365,"Rosen, Jacky",Women's Issues,1218243,1168599,49644
366,"Rounds, Mike",Leadership PACs,446467,567,445900
367,"Rounds, Mike",Securities & Investment,417728,209728,208000
368,"Rounds, Mike",Retired,335301,335301,0
369,"Rounds, Mike",Insurance,263049,40299,222750
370,"Rounds, Mike",Commercial Banks,262685,89685,173000
371,"Rubio, Marco",Retired,11679148,11679148,0
372,"Rubio, Marco",Republican/Conservative,2428661,2379678,48983
373,"Rubio, Marco",Real Estate,1362261,1310261,52000
374,"Rubio, Marco",Securities & Investment,1171546,1114546,57000
375,"Rubio, Marco",Lawyers/Law Firms,643007,541757,101250
376,"Sanders, Bernard",Retired,2193987,2193987,0
377,"Sanders, Bernard",Education,1428223,1428223,0
378,"Sanders, Bernard",Health Professionals,723816,718816,5000
379,"Sanders, Bernard",Democratic/Liberal,541708,531708,10000
380,"Sanders, Bernard",Civil Servants/Public Officials,461810,461810,0
381,"Sasse, Ben",Securities & Investment,908876,772710,136166
382,"Sasse, Ben",Leadership PACs,426300,0,426300
383,"Sasse, Ben",Retired,366568,366568,0
384,"Sasse, Ben",Real Estate,313645,249645,64000
385,"Sasse, Ben",Insurance,308789,91789,217000
386,"Schatz, Brian",Leadership PACs,342000,0,342000
387,"Schatz, Brian",Lawyers/Law Firms,268928,201178,67750
388,"Schatz, Brian",Misc Issues,227470,222970,4500
389,"Schatz, Brian",Real Estate,202277,140277,62000
390,"Schatz, Brian",Lobbyists,187550,183050,4500
391,"Schumer, Charles E.",Securities & Investment,4472335,4322334,150001
392,"Schumer, Charles E.",Lawyers/Law Firms,2975969,2715844,260125
393,"Schumer, Charles E.",Retired,2351532,2351532,0
394,"Schumer, Charles E.",Real Estate,2232082,2137082,95000
395,"Schumer, Charles E.",Electronics Mfg & Equip,886526,777726,108800
396,"Scott, Rick",Retired,3877202,3877202,0
397,"Scott, Rick",Real Estate,1308337,1300057,8280
398,"Scott, Rick",Republican/Conservative,1122959,1070909,52050
399,"Scott, Rick",Securities & Investment,1107448,1106448,1000
400,"Scott, Rick",Lawyers/Law Firms,604416,586716,17700
401,"Scott, Tim",Retired,11603095,11603095,0
402,"Scott, Tim",Securities & Investment,1760100,1492400,267700
403,"Scott, Tim",Republican/Conservative,1739472,1707639,31833
404,"Scott, Tim",Real Estate,1396840,1259540,137300
405,"Scott, Tim",Insurance,890012,455662,434350
406,"Shaheen, Jeanne",Retired,3189115,3189115,0
407,"Shaheen, Jeanne",Securities & Investment,929862,835862,94000
408,"Shaheen, Jeanne",Lawyers/Law Firms,901709,806084,95625
409,"Shaheen, Jeanne",Education,763429,763429,0
410,"Shaheen, Jeanne",Women's Issues,706690,679209,27481
411,"Shelby, Richard C.",Food Processing & Sales,10500,0,10500
412,"Shelby, Richard C.",Crop Production & Basic Processing,6000,0,6000
413,"Shelby, Richard C.",Lawyers/Law Firms,5000,0,5000
414,"Shelby, Richard C.",Defense Aerospace,5000,0,5000
415,"Shelby, Richard C.",Real Estate,4500,0,4500
416,"Sinema, Kyrsten",Securities & Investment,2683498,2360998,322500
417,"Sinema, Kyrsten",Retired,2574123,2574123,0
418,"Sinema, Kyrsten",Lawyers/Law Firms,1842180,1728430,113750
419,"Sinema, Kyrsten",Democratic/Liberal,1756656,1708077,48579
420,"Sinema, Kyrsten",Real Estate,1338060,1192660,145400
421,"Smith, Tina",Retired,2929615,2929615,0
422,"Smith, Tina",Lawyers/Law Firms,1293038,1134686,158352
423,"Smith, Tina",Women's Issues,1291293,1202618,88675
424,"Smith, Tina",Democratic/Liberal,1230131,1208673,21458
425,"Smith, Tina",Securities & Investment,1105314,935314,170000
426,"Stabenow, Debbie",Retired,1578103,1578103,0
427,"Stabenow, Debbie",Lawyers/Law Firms,948533,804383,144150
428,"Stabenow, Debbie",Securities & Investment,868417,724917,143500
429,"Stabenow, Debbie",Health Professionals,661246,403446,257800
430,"Stabenow, Debbie",Women's Issues,643159,611370,31789
431,"Sullivan, Dan",Retired,1320450,1320450,0
432,"Sullivan, Dan",Securities & Investment,997254,974254,23000
433,"Sullivan, Dan",Leadership PACs,517121,23567,493554
434,"Sullivan, Dan",Oil & Gas,376497,262197,114300
435,"Sullivan, Dan",Lawyers/Law Firms,370801,265426,105375
436,"Tester, Jon",Retired,2733639,2733639,0
437,"Tester, Jon",Lawyers/Law Firms,2517541,2388229,129312
438,"Tester, Jon",Securities & Investment,1960956,1785956,175000
439,"Tester, Jon",Real Estate,995747,877847,117900
440,"Tester, Jon",Education,794051,794051,0
441,"Thune, John",Retired,836082,836082,0
442,"Thune, John",Securities & Investment,811685,636935,174750
443,"Thune, John",Leadership PACs,440500,0,440500
444,"Thune, John",Lobbyists,432561,427561,5000
445,"Thune, John",Real Estate,379916,306416,73500
446,"Tillis, Thom",Retired,6648234,6648234,0
447,"Tillis, Thom",Securities & Investment,1921411,1659061,262350
448,"Tillis, Thom",Republican/Conservative,1868317,1805917,62400
449,"Tillis, Thom",Real Estate,1655115,1541615,113500
450,"Tillis, Thom",Health Professionals,796864,658964,137900
451,"Toomey, Patrick J.",Retired,735102,735102,0
452,"Toomey, Patrick J.",Securities & Investment,464943,323143,141800
453,"Toomey, Patrick J.",Republican/Conservative,430714,421296,9418
454,"Toomey, Patrick J.",Insurance,313034,84284,228750
455,"Toomey, Patrick J.",Lawyers/Law Firms,289920,221955,67965
456,"Tuberville, Tommy",Retired,1057591,1057591,0
457,"Tuberville, Tommy",Republican/Conservative,573130,540030,33100
458,"Tuberville, Tommy",Real Estate,561859,556859,5000
459,"Tuberville, Tommy",Securities & Investment,288133,282133,6000
460,"Tuberville, Tommy",Health Professionals,252366,234366,18000
461,"Van Hollen, Chris",Retired,1013811,1013811,0
462,"Van Hollen, Chris",Lawyers/Law Firms,881675,808175,73500
463,"Van Hollen, Chris",Securities & Investment,435990,386490,49500
464,"Van Hollen, Chris",Real Estate,412344,341834,70510
465,"Van Hollen, Chris",Leadership PACs,391400,0,391400
466,"Warner, Mark R.",Securities & Investment,2260409,2056509,203900
467,"Warner, Mark R.",Lawyers/Law Firms,1596798,1469074,127724
468,"Warner, Mark R.",Retired,1498155,1498155,0
469,"Warner, Mark R.",Real Estate,1404332,1292332,112000
470,"Warner, Mark R.",Lobbyists,572190,562640,9550
471,"Warnock, Raphael G.",Retired,15322469,15322469,0
472,"Warnock, Raphael G.",Democratic/Liberal,4390394,4271813,118581
473,"Warnock, Raphael G.",Education,3778197,3778197,0
474,"Warnock, Raphael G.",Lawyers/Law Firms,3430095,3361588,68507
475,"Warnock, Raphael G.",Health Professionals,2012354,1967354,45000
476,"Warren, Elizabeth",Retired,4403401,4403401,0
477,"Warren, Elizabeth",Education,1896732,1896732,0
478,"Warren, Elizabeth",Democratic/Liberal,1575726,1563371,12355
479,"Warren, Elizabeth",Lawyers/Law Firms,1300489,1291489,9000
480,"Warren, Elizabeth",Women's Issues,1128499,1115494,13005
481,"Whitehouse, Sheldon",Lawyers/Law Firms,840130,764035,76095
482,"Whitehouse, Sheldon",Retired,679420,679420,0
483,"Whitehouse, Sheldon",Securities & Investment,457654,448654,9000
484,"Whitehouse, Sheldon",Leadership PACs,299880,0,299880
485,"Whitehouse, Sheldon",Real Estate,291944,273544,18400
486,"Wicker, Roger F.",Securities & Investment,464352,430852,33500
487,"Wicker, Roger F.",Leadership PACs,432800,0,432800
488,"Wicker, Roger F.",Lawyers/Law Firms,358000,239500,118500
489,"Wicker, Roger F.",Lobbyists,353425,343925,9500
490,"Wicker, Roger F.",Health Professionals,313922,249422,64500
491,"Wyden, Ron",Securities & Investment,1225120,1118997,106123
492,"Wyden, Ron",Retired,1198527,1198527,0
493,"Wyden, Ron",Lawyers/Law Firms,581045,457545,123500
494,"Wyden, Ron",Real Estate,509301,423801,85500
495,"Wyden, Ron",Health Professionals,472335,207335,265000
496,"Young, Todd",Retired,1360997,1360997,0
497,"Young, Todd",Securities & Investment,1030071,908071,122000
498,"Young, Todd",Real Estate,776746,704944,71802
499,"Young, Todd",Insurance,496386,227186,269200
500,"Young, Todd",Pharmaceuticals/Health Products,424931,154381,270550